NO ./path_to_the_north_texture
SO ./path_to_the_south_texture
WE ./path_to_the_west_texture
EA ./path_to_the_east_texture

C 0,0,255
F 255,0,0

1111111111111
100000N0001
10000000001
10000000001 
1111111101111 
11111111111